{
  "field": [
    ["_", "e", "e", "e", "e", "e", "e", "e", "_"],
    ["e", "e", "y", "y", "y", "y", "y", "y", "e"],
    ["r", "e", "y", "r", "p", "b", "g", "e", "e"],
    ["r", "e", "e", "D", "D", "e", "e", "e", "e"],
    ["r", "e", "_", "_", "_", "_", "_", "e", "B"],
    ["r", "e", "e", "e", "e", "e", "e", "e", "R"],
    ["r", "e", "e", "e", "e", "e", "e", "e", "e"],
    ["_", "e", "e", "e", "e", "e", "e", "e", "_"]
  ],
  "colors": ["y", "r", "p", "b", "g"],
  "steps": 20,
  "points": 100
}
