{
  "field": [
    ["_", "e", "e", "D", "B", "e", "D", "D", "_"],
    ["e", "e", "y", "y", "y", "y", "y", "y", "e"],
    ["r", "e", "y", "r", "p", "b", "g", "e", "e"],
    ["r", "B", "R", "e", "e", "e", "e", "D", "e"],
    ["r", "e", "_", "_", "_", "_", "_", "e", "R"],
    ["r", "e", "R", "e", "e", "B", "e", "e", "R"],
    ["r", "R", "e", "e", "e", "e", "e", "e", "e"],
    ["_", "D", "e", "e", "B", "B", "e", "R", "_"]
  ],
  "colors": ["y", "r", "p", "b", "g"],
  "steps": 30,
  "points": 10
}
