{
  "field": [
    ["_", "e", "e", "e", "e", "e", "e", "e", "_"],
    ["e", "e", "y", "y", "y", "y", "y", "y", "e"],
    ["r", "e", "y", "r", "p", "b", "g", "e", "e"],
    ["r", "e", "e", "e", "e", "e", "e", "e", "e"],
    ["r", "e", "_", "_", "_", "_", "_", "e", "e"],
    ["r", "e", "R", "e", "e", "B", "e", "e", "e"],
    ["r", "e", "e", "e", "e", "e", "e", "e", "e"],
    ["_", "e", "e", "e", "e", "e", "e", "e", "_"]
  ]
}
