{
  "field": [
    ["_", "e", "e", "e", "e", "e", "e", "e"],
    ["e", "e", "y", "y", "y", "y", "y", "y"],
    ["e", "e", "y", "r", "p", "b", "g", "e"],
    ["e", "e", "e", "e", "e", "e", "e", "e"],
    ["e", "e", "_", "_", "_", "_", "_", "e"],
    ["e", "e", "e", "D", "D", "e", "e", "e"],
    ["e", "e", "e", "e", "e", "e", "e", "e"],
    ["_", "e", "e", "e", "e", "e", "e", "e"]
  ]
}
