{
  "field": [
    ["e", "e", "e", "e", "_", "e", "e", "e", "e"],
    ["e", "e", "y", "y", "_", "y", "y", "y", "e"],
    ["e", "e", "y", "r", "_", "b", "g", "e", "e"],
    ["e", "e", "e", "_", "_", "_", "e", "e", "e"],
    ["_", "_", "_", "_", "_", "_", "_", "_", "_"],
    ["e", "e", "e", "_", "_", "_", "e", "e", "e"],
    ["e", "e", "e", "e", "_", "e", "e", "e", "e"],
    ["e", "e", "e", "e", "_", "e", "e", "e", "e"],
    ["e", "e", "e", "e", "_", "e", "e", "e", "e"]
  ],
  "colors": ["y", "r", "p", "b", "g"],
  "steps": 30,
  "points": 100
}
