{
  "field": [
    ["_", "e", "e", "D", "B", "e", "D", "D", "_"],
    ["e", "e", "y", "y", "y", "y", "y", "y", "e"],
    ["r", "e", "y", "r", "p", "b", "g", "e", "e"],
    ["r", "B", "R", "e", "_", "e", "e", "D", "e"],
    ["r", "e", "e", "_", "_", "_", "e", "e", "R"],
    ["r", "e", "R", "e", "_", "B", "e", "e", "R"],
    ["r", "R", "e", "e", "e", "e", "e", "e", "e"],
    ["_", "D", "e", "e", "B", "B", "e", "R", "_"]
  ],
  "colors": ["y", "r", "p", "b", "g"],
  "steps": 30,
  "points": 100
}
